111111111111111111111111111111
1E0000010000100000C000000001C1
111000010000001111111100000101
1C00010001110000000C0000100001
110001000000000100010000100C01
10000P0C0000000100010001110001
111000010000000000000001C10001
1C0000010001000100010001000001
111111111111111111111111111111